./Dataset/OneMinuteSmile_2.wav	Actions
./Dataset/SchoolboyFascination_14.wav	Al James
./Dataset/SchoolboyFascination_15.wav	Al James
./Dataset/SchoolboyFascination_16.wav	Al James
./Dataset/SchoolboyFascination_17.wav	Al James
./Dataset/SchoolboyFascination_18.wav	Al James
./Dataset/MilkCowBlues_6.wav	Angela Thomas Wade
./Dataset/MilkCowBlues_7.wav	Angela Thomas Wade
./Dataset/MilkCowBlues_8.wav	The Sunshine Garcia Band
./Dataset/ClinicA_3.wav	ANiMAL
./Dataset/ClinicA_4.wav	ANiMAL
./Dataset/Rockshow_7.wav	ANiMAL
./Dataset/Rockshow_8.wav	ANiMAL
./Dataset/Rockshow_9.wav	ANiMAL
./Dataset/ItWasMyFaultForWaiting_6.wav	Atlantis Bound
./Dataset/ItWasMyFaultForWaiting_7.wav	Atlantis Bound
./Dataset/ItWasMyFaultForWaiting_8.wav	Atlantis Bound
./Dataset/ChildrenOfNoone_16.wav	Bill Chudziak
./Dataset/ChildrenOfNoone_17.wav	Bill Chudziak
./Dataset/ChildrenOfNoone_18.wav	Bill Chudziak
./Dataset/ChildrenOfNoone_19.wav	Bill Chudziak
./Dataset/ChildrenOfNoone_20.wav	Bill Chudziak
./Dataset/ChildrenOfNoone_21.wav	Bill Chudziak
./Dataset/TooMuch_09.wav	BKS
./Dataset/TooMuch_10.wav	BKS
./Dataset/TooMuch_11.wav	BKS
./Dataset/TooMuch_12.wav	BKS
./Dataset/TooMuch_13.wav	BKS
./Dataset/StitchUp_09.wav	Bobby Nobody
./Dataset/StitchUp_10.wav	Bobby Nobody
./Dataset/StitchUp_11.wav	Bobby Nobody
./Dataset/StitchUp_12.wav	Bobby Nobody
./Dataset/APlaceForUs_08.wav	Carlos Gonzalez
./Dataset/APlaceForUs_09.wav	Carlos Gonzalez
./Dataset/APlaceForUs_10.wav	St Vitus
./Dataset/APlaceForUs_11.wav	Young Griffo
./Dataset/Bannockburn_6.wav	Cnoc An Tursa
./Dataset/Bannockburn_7.wav	Cnoc An Tursa
./Dataset/Bannockburn_8.wav	Cnoc An Tursa
./Dataset/BurningBridges_5.wav	Dark Ride
./Dataset/BurningBridges_6.wav	Dark Ride
./Dataset/GhostBitch_7.wav	Drumtracks
./Dataset/GhostBitch_8.wav	Drumtracks
./Dataset/GhostBitch_9.wav	Drumtracks
./Dataset/EverybodysFallingApart_5.wav	Phre The Eon
./Dataset/Tiring_4.wav	Raft Monk
./Dataset/Tiring_5.wav	Raft Monk
./Dataset/Kaathaadi_2.wav	The Sunshine Garcia Band
./Dataset/Borderline_9.wav	Secretariat
./Dataset/Borderline_10.wav	Secretariat
./Dataset/OverTheTop_1.wav	Secretariat
./Dataset/SingWithMe_1.wav	Side Effects Project
./Dataset/SingWithMe_3.wav	Side Effects Project
./Dataset/WhatHaveYouDoneToMe_1.wav	Signe Jakobsen
./Dataset/HumanMistakes_9.wav	Skelpolu
./Dataset/HumanMistakes_10.wav	Skelpolu
./Dataset/HumanMistakes_11.wav	Skelpolu
./Dataset/TogetherAlone_8.wav	Skelpolu
./Dataset/TogetherAlone_9.wav	Skelpolu
./Dataset/TogetherAlone_10.wav	Skelpolu
./Dataset/BrokenMan_4.wav	Speak Softly
./Dataset/BrokenMan_5.wav	Speak Softly
./Dataset/LikeHorses_1.wav	Speak Softly
./Dataset/LikeHorses_2.wav	Speak Softly
./Dataset/MikesSulking_6.wav	Spike Mullings
./Dataset/MikesSulking_7.wav	Spike Mullings
./Dataset/WordGetsAround_10.wav	St Vitus
./Dataset/WordGetsAround_11.wav	St Vitus
./Dataset/WordGetsAround_12.wav	St Vitus
./Dataset/WordGetsAround_13.wav	St Vitus
./Dataset/LostMyWay_8.wav	Swinging Steaks
./Dataset/LostMyWay_9.wav	Swinging Steaks
./Dataset/LostMyWay_10.wav	Swinging Steaks
./Dataset/Atrophy_4.wav	The Doppler Shift
./Dataset/Atrophy_5.wav	The Doppler Shift
./Dataset/DarkHorses_7.wav	The Long Wait
./Dataset/DarkHorses_8.wav	The Long Wait
./Dataset/ForIAmTheMoon_6.wav	The Sunshine Garcia Band
./Dataset/ForIAmTheMoon_7.wav	The Sunshine Garcia Band
./Dataset/Stalker_7.wav	Tim Taler
./Dataset/Stalker_8.wav	Tim Taler
./Dataset/Stalker_9.wav	Tim Taler
./Dataset/HauntedAge_3.wav	Titanium
./Dataset/OnceMore(WithFeeling)_11.wav	Traffic Experiment
./Dataset/OnceMore(WithFeeling)_12.wav	Traffic Experiment
./Dataset/OnceMore(WithFeeling)_13.wav	Traffic Experiment
./Dataset/Angelsaint_2.wav	Triviul
./Dataset/Angelsaint_3.wav	Triviul
./Dataset/Widow_1.wav	The Fiend
./Dataset/Widow_2.wav	The Fiend
./Dataset/Femme_18.wav	Wall Of Death
./Dataset/Femme_19.wav	Wall Of Death
./Dataset/Femme_20.wav	Wall Of Death
./Dataset/Femme_21.wav	Wall Of Death
./Dataset/Femme_22.wav	Wall Of Death
./Dataset/Femme_23.wav	Wall Of Death
./Dataset/Femme_24.wav	Wall Of Death
./Dataset/BloodToBone_2.wav	Young Griffo
./Dataset/Pennies_1.wav	Young Griffo
./Dataset/Pennies_2.wav	Young Griffo
