./Dataset/OneMinuteSmile_1.wav	Actions
./Dataset/SchoolboyFascination_01.wav	Al James
./Dataset/SchoolboyFascination_02.wav	Al James
./Dataset/SchoolboyFascination_03.wav	Al James
./Dataset/SchoolboyFascination_04.wav	Al James
./Dataset/SchoolboyFascination_05.wav	Al James
./Dataset/SchoolboyFascination_06.wav	Al James
./Dataset/SchoolboyFascination_07.wav	Al James
./Dataset/SchoolboyFascination_08.wav	Al James
./Dataset/SchoolboyFascination_09.wav	Al James
./Dataset/SchoolboyFascination_10.wav	Al James
./Dataset/SchoolboyFascination_11.wav	Al James
./Dataset/SchoolboyFascination_12.wav	Al James
./Dataset/SchoolboyFascination_13.wav	Al James
./Dataset/MilkCowBlues_1.wav	Angela Thomas Wade
./Dataset/MilkCowBlues_2.wav	Angela Thomas Wade
./Dataset/MilkCowBlues_3.wav	Angela Thomas Wade
./Dataset/MilkCowBlues_4.wav	Angela Thomas Wade
./Dataset/MilkCowBlues_5.wav	Angela Thomas Wade
./Dataset/ClinicA_1.wav	ANiMAL
./Dataset/ClinicA_2.wav	ANiMAL
./Dataset/Rockshow_1.wav	ANiMAL
./Dataset/Rockshow_2.wav	ANiMAL
./Dataset/Rockshow_3.wav	ANiMAL
./Dataset/Rockshow_4.wav	ANiMAL
./Dataset/Rockshow_5.wav	ANiMAL
./Dataset/Rockshow_6.wav	ANiMAL
./Dataset/ItWasMyFaultForWaiting_1.wav	Atlantis Bound
./Dataset/ItWasMyFaultForWaiting_2.wav	Atlantis Bound
./Dataset/ItWasMyFaultForWaiting_3.wav	Atlantis Bound
./Dataset/ItWasMyFaultForWaiting_4.wav	Atlantis Bound
./Dataset/ItWasMyFaultForWaiting_5.wav	Atlantis Bound
./Dataset/ChildrenOfNoone_01.wav	Bill Chudziak
./Dataset/ChildrenOfNoone_02.wav	Bill Chudziak
./Dataset/ChildrenOfNoone_03.wav	Bill Chudziak
./Dataset/ChildrenOfNoone_04.wav	Bill Chudziak
./Dataset/ChildrenOfNoone_05.wav	Bill Chudziak
./Dataset/ChildrenOfNoone_06.wav	Bill Chudziak
./Dataset/ChildrenOfNoone_07.wav	Bill Chudziak
./Dataset/ChildrenOfNoone_08.wav	Bill Chudziak
./Dataset/ChildrenOfNoone_09.wav	Bill Chudziak
./Dataset/ChildrenOfNoone_10.wav	Bill Chudziak
./Dataset/ChildrenOfNoone_11.wav	Bill Chudziak
./Dataset/ChildrenOfNoone_12.wav	Bill Chudziak
./Dataset/ChildrenOfNoone_13.wav	Bill Chudziak
./Dataset/ChildrenOfNoone_14.wav	Bill Chudziak
./Dataset/ChildrenOfNoone_15.wav	Bill Chudziak
./Dataset/TooMuch_01.wav	BKS
./Dataset/TooMuch_02.wav	BKS
./Dataset/TooMuch_03.wav	BKS
./Dataset/TooMuch_04.wav	BKS
./Dataset/TooMuch_05.wav	BKS
./Dataset/TooMuch_06.wav	BKS
./Dataset/TooMuch_07.wav	BKS
./Dataset/TooMuch_08.wav	BKS
./Dataset/StitchUp_01.wav	Bobby Nobody
./Dataset/StitchUp_02.wav	Bobby Nobody
./Dataset/StitchUp_03.wav	Bobby Nobody
./Dataset/StitchUp_04.wav	Bobby Nobody
./Dataset/StitchUp_05.wav	Bobby Nobody
./Dataset/StitchUp_06.wav	Bobby Nobody
./Dataset/StitchUp_07.wav	Bobby Nobody
./Dataset/StitchUp_08.wav	Bobby Nobody
./Dataset/APlaceForUs_01.wav	Carlos Gonzalez
./Dataset/APlaceForUs_02.wav	Carlos Gonzalez
./Dataset/APlaceForUs_03.wav	Carlos Gonzalez
./Dataset/APlaceForUs_04.wav	Carlos Gonzalez
./Dataset/APlaceForUs_05.wav	Carlos Gonzalez
./Dataset/APlaceForUs_06.wav	Carlos Gonzalez
./Dataset/APlaceForUs_07.wav	Carlos Gonzalez
./Dataset/Bannockburn_1.wav	Cnoc An Tursa
./Dataset/Bannockburn_2.wav	Cnoc An Tursa
./Dataset/Bannockburn_3.wav	Cnoc An Tursa
./Dataset/Bannockburn_4.wav	Cnoc An Tursa
./Dataset/Bannockburn_5.wav	Cnoc An Tursa
./Dataset/BurningBridges_1.wav	Dark Ride
./Dataset/BurningBridges_2.wav	Dark Ride
./Dataset/BurningBridges_3.wav	Dark Ride
./Dataset/BurningBridges_4.wav	Dark Ride
./Dataset/GhostBitch_1.wav	Drumtracks
./Dataset/GhostBitch_2.wav	Drumtracks
./Dataset/GhostBitch_3.wav	Drumtracks
./Dataset/GhostBitch_4.wav	Drumtracks
./Dataset/GhostBitch_5.wav	Drumtracks
./Dataset/GhostBitch_6.wav	Drumtracks
./Dataset/EverybodysFallingApart_1.wav	Phre The Eon
./Dataset/EverybodysFallingApart_2.wav	Phre The Eon
./Dataset/EverybodysFallingApart_3.wav	Phre The Eon
./Dataset/EverybodysFallingApart_4.wav	Phre The Eon
./Dataset/Tiring_1.wav	Raft Monk
./Dataset/Tiring_2.wav	Raft Monk
./Dataset/Tiring_3.wav	Raft Monk
./Dataset/Kaathaadi_1.wav	Sambasevam Shanmugam chica
./Dataset/Kaathaadi_3.wav	Sambasevam Shanmugam chica
./Dataset/Kaathaadi_4.wav	Sambasevam Shanmugam chico
./Dataset/Borderline_1.wav	Secretariat
./Dataset/Borderline_2.wav	Secretariat
./Dataset/Borderline_3.wav	Secretariat
./Dataset/Borderline_4.wav	Secretariat
./Dataset/Borderline_5.wav	Secretariat
./Dataset/Borderline_6.wav	Secretariat
./Dataset/Borderline_7.wav	Secretariat
./Dataset/Borderline_8.wav	Secretariat
./Dataset/OverTheTop_2.wav	Secretariat
./Dataset/OverTheTop_3.wav	Secretariat
./Dataset/OverTheTop_4.wav	Secretariat
./Dataset/SingWithMe_2.wav	Side Effects Project
./Dataset/WhatHaveYouDoneToMe_2.wav	Signe Jakobsen
./Dataset/WhatHaveYouDoneToMe_3.wav	Signe Jakobsen
./Dataset/HumanMistakes_1.wav	Skelpolu
./Dataset/HumanMistakes_2.wav	Skelpolu
./Dataset/HumanMistakes_3.wav	Skelpolu
./Dataset/HumanMistakes_4.wav	Skelpolu
./Dataset/HumanMistakes_5.wav	Skelpolu
./Dataset/HumanMistakes_6.wav	Skelpolu
./Dataset/HumanMistakes_7.wav	Skelpolu
./Dataset/HumanMistakes_8.wav	Skelpolu
./Dataset/HumanMistakes_12.wav	Skelpolu
./Dataset/HumanMistakes_13.wav	Skelpolu
./Dataset/HumanMistakes_14.wav	Skelpolu
./Dataset/Resurrection_1.wav	Skelpolu
./Dataset/Resurrection_2.wav	Skelpolu
./Dataset/Resurrection_3.wav	Skelpolu
./Dataset/TogetherAlone_1.wav	Skelpolu
./Dataset/TogetherAlone_2.wav	Skelpolu
./Dataset/TogetherAlone_3.wav	Skelpolu
./Dataset/TogetherAlone_4.wav	Skelpolu
./Dataset/TogetherAlone_5.wav	Skelpolu
./Dataset/TogetherAlone_6.wav	Skelpolu
./Dataset/TogetherAlone_7.wav	Skelpolu
./Dataset/TogetherAlone_11.wav	Skelpolu
./Dataset/TogetherAlone_12.wav	Skelpolu
./Dataset/TogetherAlone_13.wav	Skelpolu
./Dataset/BrokenMan_1.wav	Speak Softly
./Dataset/BrokenMan_2.wav	Speak Softly
./Dataset/BrokenMan_3.wav	Speak Softly
./Dataset/LikeHorses_3.wav	Speak Softly
./Dataset/LikeHorses_4.wav	Speak Softly
./Dataset/LikeHorses_5.wav	Speak Softly
./Dataset/LikeHorses_6.wav	Speak Softly
./Dataset/LikeHorses_7.wav	Speak Softly
./Dataset/LikeHorses_8.wav	Speak Softly
./Dataset/LikeHorses_9.wav	Speak Softly
./Dataset/LikeHorses_10.wav	Speak Softly
./Dataset/MikesSulking_1.wav	Spike Mullings
./Dataset/MikesSulking_2.wav	Spike Mullings
./Dataset/MikesSulking_3.wav	Spike Mullings
./Dataset/MikesSulking_4.wav	Spike Mullings
./Dataset/MikesSulking_5.wav	Spike Mullings
./Dataset/WordGetsAround_1.wav	St Vitus
./Dataset/WordGetsAround_2.wav	St Vitus
./Dataset/WordGetsAround_3.wav	St Vitus
./Dataset/WordGetsAround_4.wav	St Vitus
./Dataset/WordGetsAround_5.wav	St Vitus
./Dataset/WordGetsAround_6.wav	St Vitus
./Dataset/WordGetsAround_7.wav	St Vitus
./Dataset/WordGetsAround_8.wav	St Vitus
./Dataset/WordGetsAround_9.wav	St Vitus
./Dataset/LostMyWay_1.wav	Swinging Steaks
./Dataset/LostMyWay_2.wav	Swinging Steaks
./Dataset/LostMyWay_3.wav	Swinging Steaks
./Dataset/LostMyWay_4.wav	Swinging Steaks
./Dataset/LostMyWay_5.wav	Swinging Steaks
./Dataset/LostMyWay_6.wav	Swinging Steaks
./Dataset/LostMyWay_7.wav	Swinging Steaks
./Dataset/Atrophy_1.wav	The Doppler Shift
./Dataset/Atrophy_2.wav	The Doppler Shift
./Dataset/Atrophy_3.wav	The Doppler Shift
./Dataset/DarkHorses_1.wav	The Long Wait
./Dataset/DarkHorses_2.wav	The Long Wait
./Dataset/DarkHorses_3.wav	The Long Wait
./Dataset/DarkHorses_4.wav	The Long Wait
./Dataset/DarkHorses_5.wav	The Long Wait
./Dataset/DarkHorses_6.wav	The Long Wait
./Dataset/ForIAmTheMoon_1.wav	The Sunshine Garcia Band
./Dataset/ForIAmTheMoon_2.wav	The Sunshine Garcia Band
./Dataset/ForIAmTheMoon_3.wav	The Sunshine Garcia Band
./Dataset/ForIAmTheMoon_4.wav	The Sunshine Garcia Band
./Dataset/ForIAmTheMoon_5.wav	The Sunshine Garcia Band
./Dataset/Stalker_1.wav	Tim Taler
./Dataset/Stalker_2.wav	Tim Taler
./Dataset/Stalker_3.wav	Tim Taler
./Dataset/Stalker_4.wav	Tim Taler
./Dataset/Stalker_5.wav	Tim Taler
./Dataset/Stalker_6.wav	Tim Taler
./Dataset/Stalker_10.wav	Tim Taler
./Dataset/Stalker_11.wav	Tim Taler
./Dataset/Stalker_12.wav	Tim Taler
./Dataset/HauntedAge_1.wav	Titanium
./Dataset/HauntedAge_2.wav	Titanium
./Dataset/OnceMore(WithFeeling)_1.wav	Traffic Experiment
./Dataset/OnceMore(WithFeeling)_2.wav	Traffic Experiment
./Dataset/OnceMore(WithFeeling)_3.wav	Traffic Experiment
./Dataset/OnceMore(WithFeeling)_4.wav	Traffic Experiment
./Dataset/OnceMore(WithFeeling)_5.wav	Traffic Experiment
./Dataset/OnceMore(WithFeeling)_6.wav	Traffic Experiment
./Dataset/OnceMore(WithFeeling)_7.wav	Traffic Experiment
./Dataset/OnceMore(WithFeeling)_8.wav	Traffic Experiment
./Dataset/OnceMore(WithFeeling)_9.wav	Traffic Experiment
./Dataset/OnceMore(WithFeeling)_10.wav	Traffic Experiment
./Dataset/Angelsaint_1.wav	Triviul
./Dataset/Angelsaint_4.wav	Triviul
./Dataset/Widow_3.wav	The Fiend
./Dataset/Widow_4.wav	The Fiend
./Dataset/Femme_1.wav	Wall Of Death
./Dataset/Femme_2.wav	Wall Of Death
./Dataset/Femme_3.wav	Wall Of Death
./Dataset/Femme_4.wav	Wall Of Death
./Dataset/Femme_5.wav	Wall Of Death
./Dataset/Femme_6.wav	Wall Of Death
./Dataset/Femme_7.wav	Wall Of Death
./Dataset/Femme_8.wav	Wall Of Death
./Dataset/Femme_9.wav	Wall Of Death
./Dataset/Femme_10.wav	Wall Of Death
./Dataset/Femme_11.wav	Wall Of Death
./Dataset/Femme_12.wav	Wall Of Death
./Dataset/Femme_13.wav	Wall Of Death
./Dataset/Femme_14.wav	Wall Of Death
./Dataset/Femme_15.wav	Wall Of Death
./Dataset/Femme_16.wav	Wall Of Death
./Dataset/Femme_17.wav	Wall Of Death
./Dataset/BloodToBone_1.wav	Young Griffo
./Dataset/Pennies_3.wav	Young Griffo
./Dataset/Pennies_4.wav	Young Griffo
./Dataset/Pennies_5.wav	Young Griffo